-----------------------------------------------------------------------------------------------------------------------------------------------------------------------------------------------------------------------
-----------------------------------------------------------------------------------------------------------------------------------------------------------------------------------------------------------------------
------------------K----------------------------------------------------------------------------------------------------------------------------------------------------------------------------------------------------
----------------l--------------------------------------------------------------------------------------------------------------------------------------------------------------------------------------------------|---
-------------------------------------------------------------------------------------------------------------------------------------------------------------------------------------------------------------------|---
-------------------##-----------------B+BBBBBBBBBBBBBBBBBBBBBBBBBBBBBBB------------------------------------------------------------------------------------------------------------------------------K---##--------|---
------------------###------------------------------------------------------------------------------------------------------------------------------------------------------------------------------------##--------|---
-----------------####------------------------------------------------------------------------------------------------------------------------------------------------------------------------------------##--------|---
-----------------####---------------------------------------------------------------------------------------------C------------------------------------V----------------------------g#----------------#--##--------|---
---------------#-####---????---------------------K-------------K--------BB--------------------BM---------BB------B#O-----------------------------------[]---------K-----K-----------##----------------#--##--------|---
----------K---##-####--------------------------------------K----------------------------CK------------------------------C-----V------K---V-------------pP-----V--------------------###----C---------#-#--##--------|---
-------------###-####------------------Y----------------------------------------C----K--c-----------C-------------------c-----[]---------[]------------pP-----[]-----K----C------g####----c--------##-#--##--------|---
------------####-####------------------y----------------------------------------c-------C-----------c--t------C--t-t----c-----pP---------pP------------pP-----pP----------c------#####-t--C-------###-#--##--------#---
##########-#####-##############-########-####-#-###-######-##############--####-#####################################################-#####-#-#------####################-#---#######################-#--##############