-------------------------------------------------------------------------------------------------------------------------------------------------------------------------------------------------------
-------------------------------------------------------------------------------------------------------------------------------------------------------------------------------------------------------
-------------------------------------------------------------------------------------------------------------------------------------------------------------------------------------------------------
---------------------------------------------------------------------------------------------------------------------------------------------------------------------------------------------------|---
----------------ooo--------------------------------------------------------------oo--------------------------------h-----------------------------------k---------------oo--------------------------|---
------------------------BBBBBM--------------------------------------------------HBB------------------------------BBBBBBB*---------------------------BBBBB--------------BBBB--------------##--------|---
-------------------------------------------------------------------------------------------------------------------------------------------------------------------------------------K--###--------|---
------------C---------------------------------------------------##----------------------------------------------------------------------------------------------------------------------###--------|---
------------c-----------ooo------------------------------------###------------------BBB-------------------------------h---------------------------------------------------------------#-###--------|---
----------####----------BBBBBB------------##------V---------#--###-------?????-?--------------------K------------BBBBBBBB---------------------BBB------------------M-----------------##-###--------|---
---------##----------------------K------h###------[]------g##--###-----------h--------------------------------V-------------#----------------------------------KK-------V------------##-###--------|---
--------###---------y-------------------#####-----pP------###--###------------------------------------C-------[]------------#-----------?M------------------------------[]---------#-##-###--------|---
-------####----k----Y------------------######-----pP---g-####--###------------------oo----------------c-------pP------------#----ttt-----------------gg-----------------pP--------##-##-###--------#---
#####################---#####################################--########################----###############################--###############-------###################---##--########-##-###############