-------------------------------------------------------------------------------------------------------------------------------------------------------------------------------------------------------------------------------------------------------------------------------------------------------------------------------------------------------------------------------------
-------------------------------------------------------------------------------------------------------------------------------------------------------------------------------------------------------------------------------------------------------------------------------------------------------------------------------------------------------------------------------------
-------------------------------------------------------------------------------------------------------------------------------------------------------------------------------------------------------------------------------------------------------------------------------------------------------------------------------------------------------------------------------------
---------------------------------------------------------------------------------------------------------------------------------------------------------------------------------------------------------------------------------------------------------------------------------------------------------------------------------------------------------------------------------|---
------------------------------------------------------------------------------------------------------oo-------------------------------------------------------------------------------------------------------------------------------------------------------------------------------------------------------------------------------------------------------------------------|---
---------------------------------------------------------------------------------------------------------------------------------------------------BBBBOBBB------------------------------------------------------------------------------------------------------------------------------------------------------------------------------------------------------------##--------|---
-----------------------------------------------------------------------------------------------------------------------------------------------------------------------------------------------------------------------------------------------------------------------------------------------------------------------------------------------------------------------##--------|---
-----------------------------------------------------------------------------------------------------------------------------------------------------------------------------------------------------------------------------------------------V---------------------------------#-----------------------------------------------------------------------------------#-##--------|---
----------------------------V----------------------------o-----------V---+--------o----V---o-----V-------------------------------------------------------------------------------BB*BBBBB-------------------------------oo-----------------V---[]-------------------------------##--oo------o----o-------------------oo---oo-----------------------------------------#-##--------|---
----------------------------[]---------------------------------------[]----V-----------[]--------[]----------------------------------V------------#----?----#--------------------------------------------------------------------------V---[]--pP------------------------------###---------------------------------------------------------------V-----------------#-#-##--------|---
----------------------------pP---------------------------------------pP----[]----------pP--------pP---------V------------------------[]-----------#-----K---#-------K------------------------------------------------------------------[]--pP--pP-----------------------------####---------------------------------------------------------------[]---------V------#-#-##--------|---
----------------------------pP---------------------------------------pP----pP----------pP--------pP---------[]-----------------------pP-----------#---------#-----------K----------------------------------#---------------------------pP--pP--pP----------------------------#####----------------------#---#------------------------------------pP---------[]---#-#-#-##--------|---
-------t-------g-g-------g--pP----k-k---------------k---------gg-g---pP--t-pP----------pP--------pP-g-gg----pP-k-----k----kk-k-------pP-----g-gg--#---------#------------------------------------------kk--#---------------------gg-g--pP--pP--pP---t----gg-g--g---------g--######t---------------------#-k-#-----------------------k------k-kk--pP---------pP---#-#-#-##--------#---
#######################################-#-##-##-##-###############################################################################################################-#-##-#-##-#################-#-#-###################------##########-##--##--############################################---##---################-----#----###################################-#-#-#-##############