--------------------------------------------------------------------------------------------------------------------------------------------------------------------------------
--------------------------------------------------------------------------------------------------------------------------------------------------------------------------------
------------------------------------------------------------------------------------------------------------------------------------------------M-------------------------------
----------------------------------------------------------------------------------------------------------------------------------------------------------------------------|---
--------------------------------------------------------------------------------h-------------------------------------------------------------------------------------------|---
--------------------MBB-----------------------------------------------------BBBBBB----+----------------------------------------BBBBB------------------------------##--------|---
--------------------------------------------------------------------------------------------------------------------------------------------------BB------------t###--------|---
---------------------------------------------------------C---------------------------------------------------------------------------------------------#--------####--------|---
---------------------------------------------------------c-------------------h--------------------------------------------------h-------------BB------##-------#####--------|---
--------------------------------????-------------------BB#OB---------V-----BBBBBBB----V---------------V------------------------BBBBB-----------------###------######--------|---
-----------------K---C-----------------C-----K---C-------------------[]---------------[]--------------[]----V------------V------------#----C--------####-----#######--------|---
------------C--------c-------C--K------c---------c-----------C-------pP---------------pP---------C----pP----[]-----C-----[]-----------#----c----Y--#####----########--------|---
------------c--------C-------c---------c---------C-----------c-------pP---------------pP---------c----pP-k--pP-----c-----pP------h----#----C----y-######---#########--------#---
##################################################################--#############################################################################-##############################
