------------------------------------------------------------------------------------------------------------------------------------------------------------------------------------------------------------------------------
------------------------------------------------------------------------------------------------------------------------------------------------------------------------------------------------------------------------------
------------------------------------------------------------------------------------------------------------------------------------------------------------------------------------------------------------------------------
--------------------------l-----------------------------------------------------------------------------------------------------------------------------------------------------------------------------------------------|---
--------------------------------------------------------------------------------------------------------------------------------------------------------------------------------------------------------------------------|---
------------------?--------------------------------------?-?-------------------------+-------------------------------------------------------????---------------------------------------------------------------##--------|---
--------------------------------------------------------------------------------------------------oooo----------oooo------------oooo---------------------------------------------------------------------------###--------|---
--------------------------------------------------------------------------------------------------------------------------------------------------------------------------------------------------------------####--------|---
-----------------------------------oo------------------------------------------------------------------------V---------------V-------------------------------------------------------------------------------#####--------|---
--------------V---M---------------o--o-------------------?-?-----------------------????----------------------[]--------------[]------------??MBB???---------------------------------------------------------######---O----|---
--------------[]--------------------------------------------------------------------------------#------------pP--------------pP-----------------------------V-------------------------#--------------------#######--------|---
--------------pP--------------------------------------------------------------------------------#------------pP--------------pP-----------------------------[]------------------------#-------------------########--------|---
--------------pP--------------------------------------------------------------------------------#------------pP--------------pP-----------------------------pP------------------------#------------------#########--------#---
#########################--############################################----###################################################################--#######################---###--########--#####################################
