-----------------------------------------------------------------------------------------------------------------------------------------------------------------------------------------------------------------------
-----------------------------------------------------------------------------------------------------------------------------------------------------------------------------------------------------------------------
-----------------------------------------------------------------------------------------------------------------------------------------------------------------------------------------------------------------------
--------------------------------------------------------------------------------------------------------------------------------------------------------------------------------------------------------------------|--
-------------------------------------------------------------------------------------------------------------------t------------------------------------------------------------------------------------------------|--
------------------BOB------V----------------------------------BBBBB-----BBBBH-----------------------------V---B---BBBBBBBBB------------*B---BB-------------BBB----V--------------------------------------###--------|--
---------------------------[]----------------------------V------------------------V-----------------------[]------------------------------------------------------[]--------------------------------K---####--------|--
---------------------------pP----------------------V-----[]-----------------------[]----------------------pP------------------------------------------------------pP-----------------------------------#####--------|--
--------------V--------V---##------------V---------[]----pP-----------------------pP-------------V--------pP-------------------------BB---------------------------pP-----V--------V-----------------V-######--------|--
-----BBB------[]---?---[]----------------[]---BM---pP----##----------------V-?----pP-----V-------[]------B##B------------------------------BBB------V--##--BBB----##-----[]-----V-[]----V-----------[]######--------|--
--------------pP-------pP-----V-V--------pP--------pP---------V------V-----[]--V--pP-----[]------pP-V---------V---------------V---V---------------#-[]-##----------------pP---V-[]pP----[]----------pP######--------|--
--------------pP-------pP-----[][]-------pP--------pP---------[]-----[]----pP--[]-pP-----pP------pP-[]--------[]--------------[]--[]-------------##-pP-###---------------pP---[]pPpP----pP---------#pP######--------|--
--------------pP----k--pP-----pPpP-------pP---t----pP---------pP-----pP----pP--pP-pP--t--pP------pP-pP--------pP--------------pP--pP------------###-pP-###t-------g------pP---pPpPpP----pP--------##pP######--------#--
######################################################################################################################------############-#-########-###################################################################
