--------------------------------------------------------------------------------------------------------------------------------------------------------------------------------------------------------------
--------------------------------------------------------------------------------------------------------------------------------------------------------------------------------------------------------------
---------------------------------------------+-----------------------------------------------------------------------------V----------------------------------------------------------------------------------
---------------------------------------------------------------------------------------------------------------------------[]-------------------------------dD------------xx------------------------------|---
--------------------BBB----BBBH---------------------h----------------------------------------------------------------------pP-------------------------------dD-----------xx-xx-k----------------xx--------|---
-------#??M??#--------------------------BBBBBB----???????----------------k-----------------------------------------------BBBBBBB---------------K-----K------dD------xx--xx----xB---------------xx-x-vv----|---
-------#-----#---------------------------dD-----------------------------BBBB----------------------------------------------------------------K---------------dD-----xx-x-x------xx------------x-x-k-x------|---
-------#-----#------#--------------------{}----------------------------------------------------------------------------------------------xxxxxxxxxxxxxx-----dD-----x---x-------O-x----------xxx--#--x-----|---
-------#k--k-#------#kk-------#----------X-----------h--------------#-k--k---------------------------xx-------------------h--h----------x#BBBBBBBBBBBM-x----dD--xxx----k----------x---------x-k--#---x----|---
-------#??-??#------#BBBBBBBBB#-xx-------xx------?????M??-----------#BBBBBBB---#--------------------xx-xxx---------------BBBBBBB-------x##--------------x---dD--x??----#-------k---x------xx--#--#----x---|---
-------------------------------xx-x-----xx-x--------------------xxx---------kk-#------------------x-x--[]-x-----?M???-----------------x###--V-oooooo-----x--{}--x------#-------#----x----xxk--#--#-----x--|---
-------------K-----------------x---x----x---x-------------------x#-xBBBBBBBBBBB#-----------------x-x---pP--x-------------------------x####--[]------------x-X---x------#----Y--#-----x---x-#--#--#------x-xx-x
--xxxxxxxxxxxxxxxxxxxxxxxxxxxxx-----xxxx-----xxxxxxxxxxxxxxxxxxx-#--xxxxxxxxxxxxxxxxxxxxxxxxxxxxxk-k---pP---xxxxxxxxxxxxxxxxxxxxxxxxx#####--pPoooooo-------xxxxx-------#----y--#------xxx--#--#--#-------x#-x-
###############################----###[]----#################################################################################pP#######################-----#[]#####--############-#######--#--#--#-----#######
