-----------------------------------------------------------------------------------------------------------------------------------------------------------------------------------------------------------------------
-----------------------------------------------------------------------------------------------------------------------------------------------------------------------------------------------------------------------
-----------------------------------------------------------------------------------------------------------------------------------------------------------------------------------------------------------------------
------------------------------------------------------------------------------------------------------------------------------------------------------------------------------------------------------------x----------
---------------------------------------------xx-------------------------------------xx-------------------------------------------------------------------------------------------------------------------xxx-x---------
--------------------------------------------xx-xxx-----------------------------xx---x-x------xx---------------------------------------------------------------------------------------------------------x-----x--------
------------------------------------xx-----xx-----x---------------------------xx-xxx---x----xx-xxx----------------------------------------------------------------------------------xx-----------------x-------x-------
-----------------------------------xx-xxx--x-------xxx------------------xx---xx---------x--xx-----x---------------------------------------------------xx-------------------x--------x-x-------------x-x---------x------
-------------xxx------xxxx--------xx-----xx-----------x----------------xx-x--x-----------x-x-------x-----------------xx---------xx-----------------x--x-xx--------------xxx-x-----xx---x-----------x-x-----------x-----
------------xx--xx---xx---x-------x--------------------x---------------x---xx-------------x---------x---------------xx-xxx------x-x---------------x-xx----x-------------x----x--xx------xxx--------x--------------x----
-----------xx-----x--x-----x-xxxxx----------------------x----xxxx---xxx------------------------------xx------xxxx--xx-----x--xxx---xx------------x---------x------------x-----xx-----------x-------x---------------x-x-
-----------x--------x--------x---------------------------x---x---x--x----------------------------------x-----x---x-x-------x-x-------x--x-x-----x-----------x-----xx----x-------------------x-----x-----------------x-x
--xxxxxxxxx--------x--------x-----------------------------xxx-----xx------------------------------------xxxxx-----x---------x---------xx-x-xxxxx-------------xxxxx--xxxx---------------------xxxxx---------------------
-----------------------------------------------------------------------------------------------------------------------------------------------------------------------------------------------------------------------
