-----------------------------------------------------------------------------------------------------------------------------------------------------------------------------------------x-----------
--------------------------------------------------------------------------------------------------------------------------------------------------------------------------------------xxx-x----------
-------------------------------------------------------------------------------------------------------------------------------------------------------------------------------------x-----x---------
-------------------------------------------------------------------------------------------------------------------------------------------------------------------------------------x------x--------
-------------------------------------------------------------------------------------------------------------------------------------------------------------------------------------x-------x-------
-------------------------------------------------------------------------------------------------------------------------------------------------------------------------------------x--------x------
--------------------------------------------------------------------------------------------------------------------------xx---------------------------------------------------------x---------x-----
---------------x-xx-------xx------------------------------------xx---------------------------------------------------x---xx-xx-------------------------------------------------------x----------x----
--------------x-x--x-----xx-xxx-------xxx----------------------xx-xxx--------------------------xxxx---------------xxx-x--x----x------------------------------------------------------x-----------x---
--------------x-----x---xx-----x-----xx--xx-------------------xx-----x----------------xx------xx---x-------xx-x--xx----xx------x------------------xxx--------------------xxx---------x------------x--
--------------x------x--x-------x---xx-----x------------------x-------x------x-------xx-x-----x-----x------x-x-x-x--------------x---xx-----------xx--x------------------x---x-------xx-------------x-
-------------x--------xx---------xx-x-------x-------xxx--xx-xx---------x----x-xxx----x---x---x-------x----x-----x----------------x--x-x----------x----x--xxx------------x----x------x---------------x
--xxxxxxxxxxx----------------------x---------xxxxxxx---xx--x------------xxxx-----xxxx-----xxx---------xxxx------------------------xx---xxxxxxxxxx------xx---xxxxxxxxxxxxx-----xxxxxx-----------------
-----------------------------------------------------------------------------------------------------------------------------------------------------------------------------------------------------
